...###....#
..##.#.####
..#..#.#..#
#.........#
#...@..#..#
#.#..###..#
..#..#....#
.##.##.#.##
.#......##
.#.....##
########