@..#...#..#
..##.#.#.##
..#..#.#..#
#......#..#
#...#..#..#
#.#..###..#
..#.......#
.##.##...##
#.......##
#...#...#
########