...#...#..#
....##.#.##
..#..#.#..#
#......#..#
#...#.....#
#.#.......#
..#.###...#
..#.##...##
#........#
#..###.@#
########